211111111131111111112
100000000000000000001
100000000000000000001
100000000000000000001
100000000000000000001
300000000000000000003
100000000000000000001
100000000000000000001
100000000000000000001
100000000000000000001
211111111131111111112