322222222242222222223
211111111111111111112
211111511111115111112
211111111111111111112
211111111111111111112
411111111111111511114
211151111111111111112
211111111111511111112
211111111111111111112
211111111111511111112
322222222242222222223