0000000000000000000000000000000000000000
0000000000000000000000000000000000000000
0000000000000000000000000000000000000000
0000000000000000000000000000000000000000
0111100000000000000000000000000000001111
0222210000000000000000000000000000000200
0000000000011111111111111111110000000000
0000000000000000000000000000000000000000
0000000111111111111111111111111111000000
0000000222222222222222222222222220000000
0000000000000000000000000000000000000000
0000000000000000000000000000000000000000
0000011111111111111111111111111111111111
0001122222222222222222222222222222222222
0012222222222222222222222222222222222222